x##################<x
vS0 0 0 0 0 0 0 0 0 #
#0000000000000000000#
# 0 0 0 0 0 0 0 0 0 #
#0000000000000000000#
# 0 0 0 0 0 0 0 0 0 #
#0000000000000000000#
# 0 0 0 0 0 0 0 0 0 #
#0000000000000000000#
# 0 0 0 0 0 0 0E0 0 #
#0000000000000000000#
# 0 0 0 0 0 0 0 0 0 #
#0000000000000000000#
# 0 0 0 0 0 0 0 0 0 #
#0000000000000000000#
# 0 0 0 0 0 0 0 0 0 #
#0000000000000000000#
# 0 0 0 0 0 0 0 0 0 #
#0000000000000000000#
# 0 0 0 0 0 0 0 0 0 #
x>#################x^
