>##################xv
vS0       0 0   0 0 #
# 0 00000 0 0 000 0 #
#   0   0 0 0 0   0 #
# 00000 0 0 0 0 0 0 #
#   0       0 0 0   #
#00 >#############x #
#   0     0       0 #
# 000 000 000 00000 #
#     0   0   0E  0 #
#000000 0 0 00000 0 #
#       0 0 0 0 0 0 #
# 00000 0 0 0 0 0 0 #
#       0 0 0   0 0 #
# 0 0 0 0 0 0 0 0 0 #
# 0 0 0 0 0 0 0   0 #
# 0 >#####x 0 >###x #
# 0           0 0 0 #
# 0000000000000 000 #
#           0       #
x>#################xx
