>##################xv
vSv       v v   v v #
# x v>#xv # # v0x # #
#   #   # # # #   # #
# >x#>x x x # # v x #
#   x       x x x   #
#>x >#############x #
#   v     v       v #
# >xx v>x #>x v>#x# #
#     #   #   #E  # #
#>###xx v # v0#0v # #
#       # # # x # # #
# >###x # # #   # # #
#       # # # v # # #
# v v v # # # # x # #
# # x x x x # x   x #
# # >#####x x >###x #
# #           v v v #
# x>#######xv0x x0x #
#           x       #
x>#################xx
